newnpc2
Pablo
19,18
mapa para probar npc
%MAPSOUND%

1:0-0:101;1:0-0:101;1:0-0:101;1:0-0:101;1:0-0:101;1:0-0:101;1:0-0:101;1:0-0:101;1:0-0:101;1:0-0:101;1:0-0:101;1:0-0:101;1:0-0:101;1:0-0:101;1:0-0:101;1:0-0:101;1:0-0:101;1:0-0:101;1:0-0:101
1:0-0:101;1:0-0:101;1:0-0:101;1:0-0:101;1:0-0:101;1:0-0:101;1:0-0:101;1:0-0:101;1:0-0:101;1:0-0:101;1:0-0:101;1:0-0:101;1:0-0:101;1:0-0:101;1:0-0:101;1:0-0:101;1:0-0:101;1:0-0:101;1:0-0:101
1:0-0:101;1:0-0:101;1:0-0:101;1:0-0:101;1:0-0:101;1:0-0:101;1:0-0:101;1:0-0:101;1:0-0:101;1:0-0:101;1:0-0:101;1:0-0:101;1:0-0:101;1:0-0:101;1:0-0:101;1:0-0:101;1:0-0:101;1:0-0:101;1:0-0:101
0:0-0:101;0:0-0:101;0:0-0:101;0:0-0:101;1:0-0:101;1:0-0:101;1:0-0:101;1:0-0:101;1:0-0:101;1:0-0:101;1:0-0:101;1:0-0:101;1:0-0:101;1:0-0:101;1:0-0:101;1:0-0:101;1:0-0:101;1:0-0:101;1:0-0:101
0:0-0:101;0:0-0:101;0:0-0:101;0:0-0:101;1:0-0:101;1:0-0:101;1:0-0:101;1:0-0:101;1:0-0:101;1:0-0:101;1:0-0:101;1:0-0:163;1:0-0:163;1:0-0:163;1:0-0:163;1:0-0:163;1:0-0:101;1:0-0:101;1:0-0:101
0:0-0:101;0:14-411:101;0:0-0:101;0:0-0:101;1:0-0:101;1:0-0:101;1:0-0:101;1:0-0:101;1:0-0:101;1:0-0:101;1:0-0:101;1:0-0:163;1:0-0:163;1:0-0:163;1:0-0:163;1:0-0:163;1:0-0:101;1:0-0:101;1:0-0:101
0:0-0:101;0:0-0:101;0:0-0:101;0:0-0:101;1:0-0:101;1:0-0:101;1:0-0:101;1:0-0:101;0:0-0:101;0:0-0:101;0:0-0:101;0:0-0:163;0:0-0:163;1:43-0-Mago inquieto,311,Un mago muy inquieto,Nada que decir/Tengo mucha pena/Sabes por que?/{si}Bien por ti%{no}No te interesa,%NULL%,%NULL%,0,True,2,False:196;1:0-0:163;1:0-0:163;1:0-0:101;1:0-0:101;1:0-0:101
0:0-0:101;0:0-0:101;0:0-0:101;0:0-0:101;1:0-0:101;1:0-0:101;1:0-0:101;1:0-0:101;0:0-0:101;0:0-0:101;0:0-0:101;0:0-0:163;0:0-0:163;1:0-0:163;1:0-0:163;1:0-0:163;1:0-0:101;1:0-0:101;1:0-0:101
1:0-0:101;1:0-0:101;1:0-0:162;1:0-0:162;1:0-0:162;1:0-0:101;1:0-0:101;1:0-0:101;0:0-0:101;0:0-0:101;0:14-411:101;0:0-0:163;0:0-0:163;1:0-0:163;1:0-0:163;1:0-0:163;1:0-0:101;1:0-0:101;1:0-0:101
1:0-0:101;1:0-0:101;1:0-0:162;1:43-0-Fantasmagólico brutal,347,Muy fantasmal,Hola%XLASH%Soy un fantasmaaah,%NULL%,%NULL%,0,True,1,False,:196;1:0-0:162;1:0-0:101;1:0-0:101;1:0-0:101;0:0-0:101;0:0-0:101;0:0-0:101;0:0-0:101;0:0-0:101;1:0-0:101;1:0-0:101;1:0-0:101;1:0-0:101;1:0-0:101;1:0-0:101
1:0-0:101;1:0-0:101;0:0-0:162;0:0-0:162;0:0-0:162;0:0-0:101;0:0-0:101;1:0-0:101;0:0-0:101;0:0-0:101;0:0-0:101;0:0-0:101;0:0-0:101;1:0-0:101;1:0-0:101;1:0-0:101;1:0-0:101;1:0-0:101;1:0-0:101
1:0-0:101;1:0-0:101;0:0-0:101;0:0-0:101;0:0-0:101;0:0-0:101;0:0-0:101;1:0-0:101;1:0-0:101;1:0-0:101;1:0-0:101;1:0-0:101;1:0-0:101;1:0-0:101;1:0-0:101;1:0-0:101;1:0-0:101;1:0-0:101;1:0-0:101
1:0-0:101;1:0-0:101;0:0-0:101;0:0-0:101;0:14-411:101;0:0-0:101;0:0-0:101;1:0-0:101;1:0-0:101;1:0-0:101;1:1-999:101;1:0-0:101;1:0-0:101;1:0-0:101;1:0-0:101;1:0-0:101;1:0-0:101;1:0-0:101;1:0-0:101
1:0-0:101;1:0-0:101;0:0-0:101;0:0-0:101;0:0-0:101;0:0-0:101;0:0-0:101;1:0-0:101;1:0-0:101;1:0-0:101;1:0-0:101;1:0-0:101;1:0-0:101;1:0-0:101;1:0-0:101;1:0-0:101;1:0-0:101;1:0-0:101;1:0-0:101
1:0-0:101;1:0-0:101;0:0-0:101;0:0-0:101;0:0-0:101;0:0-0:101;0:0-0:101;1:0-0:101;1:0-0:101;1:0-0:101;1:0-0:101;1:0-0:101;1:0-0:101;1:0-0:101;1:0-0:101;1:0-0:101;1:0-0:101;1:0-0:101;1:0-0:101
1:0-0:101;1:0-0:101;1:0-0:101;1:0-0:101;1:0-0:101;1:0-0:101;1:0-0:101;1:0-0:101;1:0-0:101;1:0-0:101;1:0-0:101;1:0-0:101;1:0-0:101;1:0-0:101;1:0-0:101;1:0-0:101;1:0-0:101;1:0-0:101;1:0-0:101
1:0-0:101;1:0-0:101;1:0-0:101;1:0-0:101;1:0-0:101;1:0-0:101;1:0-0:101;1:0-0:101;1:0-0:101;1:0-0:101;1:0-0:101;1:0-0:101;1:0-0:101;1:0-0:101;1:0-0:101;1:0-0:101;1:0-0:101;1:0-0:101;1:0-0:101
1:0-0:101;1:0-0:101;1:0-0:101;1:0-0:101;1:0-0:101;1:0-0:101;1:0-0:101;1:0-0:101;1:0-0:101;1:0-0:101;1:0-0:101;1:0-0:101;1:0-0:101;1:0-0:101;1:0-0:101;1:0-0:101;1:0-0:101;1:0-0:101;1:0-0:101
