testlighteffect
Pablo
19,18
Mapa que prueba las luces
%MAPSOUND%

1:0-0:101;1:0-0:101;1:0-0:101;1:0-0:101;1:0-0:101;1:0-0:101;1:0-0:101;1:0-0:101;1:0-0:101;1:0-0:101;1:0-0:101;1:0-0:101;1:0-0:101;1:0-0:101;1:0-0:101;1:0-0:101;1:0-0:101;1:0-0:101;1:0-0:101
1:0-0:101;1:0-0:101;1:0-0:101;1:0-0:101;1:0-0:101;0:0-0:101;0:0-0:101;0:0-0:101;0:0-0:101;0:0-0:101;0:0-0:101;0:0-0:101;0:0-0:101;1:0-0:101;1:0-0:101;1:0-0:101;1:0-0:101;1:0-0:101;1:0-0:101
1:0-0:101;1:0-0:101;1:0-0:101;1:0-0:101;1:0-0:101;0:0-0:101;0:14-420:101;0:0-0:101;0:14-429:101;0:0-0:101;0:0-0:101;0:14-430:101;0:0-0:101;0:0-0:101;0:0-0:101;0:0-0:101;1:0-0:101;1:0-0:101;1:0-0:101
1:0-0:101;0:0-0:101;0:0-0:101;0:0-0:101;0:0-0:101;0:0-0:101;0:0-0:101;0:0-0:101;0:0-0:101;0:0-0:101;0:0-0:101;0:0-0:101;0:0-0:101;0:0-0:101;0:14-431:101;0:0-0:101;1:0-0:101;1:0-0:101;1:0-0:101
1:0-0:101;0:0-0:101;0:39-961:101;0:0-0:101;0:14-418:101;0:0-0:101;0:0-0:101;0:0-0:101;0:0-0:101;0:0-0:101;0:0-0:101;0:0-0:101;0:0-0:101;0:0-0:101;0:0-0:101;0:0-0:101;1:0-0:101;1:0-0:101;1:0-0:101
1:0-0:101;0:0-0:101;0:0-0:101;0:0-0:101;0:0-0:101;0:0-0:101;0:14-419:101;0:0-0:101;0:0-0:101;0:14-421:101;0:0-0:101;0:0-0:101;0:14-428:101;0:0-0:101;1:0-0:101;1:0-0:101;1:0-0:101;1:0-0:101;1:0-0:101
1:0-0:101;1:0-0:101;1:0-0:101;0:0-0:101;0:14-416:101;0:0-0:101;0:0-0:101;0:0-0:101;0:0-0:101;0:0-0:101;0:0-0:101;0:0-0:101;0:0-0:101;0:0-0:101;1:0-0:101;1:0-0:101;1:0-0:101;1:0-0:101;1:0-0:101
1:0-0:101;1:0-0:101;1:0-0:101;0:0-0:101;0:0-0:101;0:0-0:101;0:0-0:101;0:14-417:101;0:0-0:101;0:0-0:101;0:0-0:101;0:0-0:101;0:0-0:101;1:0-0:101;1:0-0:101;1:0-0:101;1:0-0:101;1:0-0:101;1:0-0:101
1:0-0:101;1:0-0:101;1:0-0:101;1:0-0:101;1:0-0:101;0:0-0:101;0:14-412:101;0:0-0:101;0:0-0:101;0:14-423:101;0:0-0:101;0:14-427:101;0:0-0:101;1:0-0:101;1:0-0:101;1:0-0:101;1:0-0:101;1:0-0:101;1:0-0:101
1:0-0:101;1:0-0:101;0:0-0:101;0:0-0:101;0:0-0:101;0:0-0:101;0:0-0:101;0:0-0:101;0:0-0:101;0:0-0:101;0:0-0:101;0:0-0:101;0:0-0:101;1:40-269:101;1:40-269:101;1:0-0:101;1:0-0:101;1:0-0:101;1:0-0:101
1:0-0:101;1:0-0:101;0:0-0:101;0:14-408:101;0:0-0:101;1:0-0:101;0:0-0:101;0:14-413:101;0:0-0:101;0:0-0:101;0:0-0:101;0:0-0:101;0:40-269:101;0:40-269:101;1:40-269:101;1:0-0:101;1:0-0:101;1:0-0:101;1:0-0:101
1:0-0:101;1:0-0:101;0:0-0:101;0:0-0:101;0:0-0:101;0:0-0:101;0:0-0:101;0:14-422:101;0:0-0:101;0:14-425:101;0:0-0:101;0:0-0:101;0:14-426:101;0:40-269:101;1:40-269:101;1:0-0:101;1:0-0:101;1:0-0:101;1:0-0:101
1:0-0:101;1:0-0:101;0:0-0:101;0:0-0:101;0:0-0:101;0:0-0:101;0:14-411:101;0:0-0:101;0:0-0:101;0:0-0:101;0:0-0:101;0:0-0:101;0:0-0:101;0:1-999:101;1:0-0:101;1:0-0:101;1:0-0:101;1:0-0:101;1:0-0:101
1:0-0:101;1:0-0:101;0:0-0:101;0:14-414:101;0:0-0:101;0:0-0:101;0:0-0:101;0:0-0:101;0:0-0:101;0:0-0:101;0:0-0:101;0:0-0:101;0:0-0:101;1:0-0:101;1:0-0:101;1:0-0:101;1:0-0:101;1:0-0:101;1:0-0:101
1:0-0:101;1:0-0:101;0:0-0:101;0:0-0:101;0:0-0:101;0:0-0:101;0:0-0:101;0:0-0:101;0:14-424:101;0:0-0:101;0:0-0:101;0:14-432:101;0:0-0:101;1:0-0:101;1:0-0:101;1:0-0:101;1:0-0:101;1:0-0:101;1:0-0:101
1:0-0:101;1:0-0:101;1:0-0:101;1:0-0:101;0:0-0:101;0:14-415:101;0:0-0:101;0:0-0:101;0:0-0:101;0:0-0:101;0:0-0:101;0:0-0:101;0:0-0:101;1:0-0:101;1:0-0:101;1:0-0:101;1:0-0:101;1:0-0:101;1:0-0:101
1:0-0:101;1:0-0:101;1:0-0:101;1:0-0:101;0:0-0:101;0:0-0:101;0:0-0:101;1:0-0:101;1:0-0:101;1:0-0:101;1:0-0:101;1:0-0:101;1:0-0:101;1:0-0:101;1:0-0:101;1:0-0:101;1:0-0:101;1:0-0:101;1:0-0:101
1:0-0:101;1:0-0:101;1:0-0:101;1:0-0:101;1:0-0:101;1:0-0:101;1:0-0:101;1:0-0:101;1:0-0:101;1:0-0:101;1:0-0:101;1:0-0:101;1:0-0:101;1:0-0:101;1:0-0:101;1:0-0:101;1:0-0:101;1:0-0:101;1:0-0:101
