testlava123
pablo
18,18
testlaba
%MAPSOUND%

1:0-0:101;1:0-0:101;1:0-0:101;1:0-0:101;1:0-0:101;1:0-0:101;1:0-0:101;1:0-0:101;1:0-0:101;1:0-0:101;1:0-0:101;1:0-0:101;1:0-0:101;1:0-0:101;1:0-0:101;1:0-0:101;1:0-0:101;1:0-0:101
1:0-0:101;1:0-0:101;1:0-0:101;1:0-0:101;1:0-0:101;1:0-0:101;1:0-0:101;1:0-0:101;1:0-0:101;1:0-0:101;1:0-0:101;1:0-0:101;0:0-0:101;0:0-0:101;0:0-0:101;0:0-0:101;1:0-0:101;1:0-0:101
1:0-0:101;1:0-0:101;1:0-0:101;1:0-0:101;1:0-0:101;1:0-0:101;1:0-0:101;1:0-0:101;1:0-0:101;1:0-0:101;0:0-0:101;0:0-0:101;0:0-0:101;0:4-0:151;0:4-0:151;0:0-0:101;0:0-0:101;1:0-0:101
1:0-0:101;1:0-0:101;1:0-0:101;1:0-0:101;1:0-0:101;1:0-0:101;1:0-0:101;1:0-0:101;1:0-0:101;0:0-0:101;0:0-0:101;0:4-0:151;0:4-0:151;0:4-0:151;0:4-0:151;0:4-0:151;0:0-0:101;1:0-0:101
1:0-0:101;1:0-0:101;1:0-0:101;1:0-0:101;1:0-0:101;1:0-0:101;1:0-0:101;1:0-0:101;1:0-0:101;0:0-0:101;0:4-0:151;0:4-0:151;0:4-0:151;0:4-0:151;0:4-0:151;0:4-0:151;0:0-0:101;1:0-0:101
1:0-0:101;1:0-0:101;1:0-0:101;1:0-0:101;1:0-0:101;1:0-0:101;1:0-0:101;1:0-0:101;1:0-0:101;0:0-0:101;0:0-0:101;0:4-0:151;0:4-0:151;0:4-0:151;0:4-0:151;0:0-0:101;0:0-0:101;1:0-0:101
1:0-0:101;1:0-0:101;1:0-0:101;1:0-0:101;1:0-0:101;1:0-0:101;1:0-0:101;1:0-0:101;1:0-0:101;1:0-0:101;0:0-0:101;0:4-0:151;0:4-0:151;0:4-0:151;0:4-0:151;0:4-0:151;0:0-0:101;1:0-0:101
1:0-0:101;1:0-0:101;1:0-0:101;1:0-0:101;1:0-0:101;1:0-0:101;1:0-0:101;1:0-0:101;1:0-0:101;1:0-0:101;0:0-0:101;0:0-0:101;0:4-0:151;0:4-0:151;0:4-0:151;0:0-0:101;0:0-0:101;1:0-0:101
1:0-0:101;1:0-0:101;1:0-0:101;1:0-0:101;1:0-0:101;1:0-0:101;1:0-0:101;1:0-0:101;1:0-0:101;1:0-0:101;1:0-0:101;0:0-0:101;0:0-0:101;0:4-0:151;0:4-0:151;0:0-0:101;1:0-0:101;1:0-0:101
1:0-0:101;1:0-0:101;1:0-0:101;1:0-0:101;1:0-0:101;1:0-0:101;1:0-0:101;1:0-0:101;1:0-0:101;1:0-0:101;1:0-0:101;1:0-0:101;0:0-0:101;0:4-0:151;0:0-0:101;0:0-0:101;1:0-0:101;1:0-0:101
1:0-0:101;1:0-0:101;1:0-0:101;1:0-0:101;1:0-0:101;1:0-0:101;1:0-0:101;1:0-0:101;1:0-0:101;1:0-0:101;1:0-0:101;1:0-0:101;0:0-0:101;0:0-0:101;0:0-0:101;1:0-0:101;1:0-0:101;1:0-0:101
1:0-0:101;1:0-0:101;1:0-0:101;1:0-0:101;1:0-0:101;1:0-0:101;1:0-0:101;1:0-0:101;1:0-0:101;1:0-0:101;1:0-0:101;1:0-0:101;1:0-0:101;1:0-0:101;1:0-0:101;1:0-0:101;1:0-0:101;1:0-0:101
1:0-0:101;1:0-0:101;1:0-0:101;1:0-0:101;1:0-0:101;1:0-0:101;1:0-0:101;1:0-0:101;1:0-0:101;1:0-0:101;1:0-0:101;1:0-0:101;1:0-0:101;1:0-0:101;1:0-0:101;1:0-0:101;1:0-0:101;1:0-0:101
1:0-0:101;1:0-0:101;1:0-0:101;1:0-0:101;1:0-0:101;1:0-0:101;1:0-0:101;1:0-0:101;1:0-0:101;1:0-0:101;1:0-0:101;1:0-0:101;1:0-0:101;1:0-0:101;1:0-0:101;1:0-0:101;1:0-0:101;1:0-0:101
1:0-0:101;1:0-0:101;1:0-0:101;1:0-0:101;1:0-0:101;1:0-0:101;1:0-0:101;1:0-0:101;1:0-0:101;1:0-0:101;1:0-0:101;1:0-0:101;1:0-0:101;1:0-0:101;1:0-0:101;1:0-0:101;1:0-0:101;1:0-0:101
1:0-0:101;1:0-0:101;1:0-0:101;1:0-0:101;1:0-0:101;1:0-0:101;1:0-0:101;1:0-0:101;1:0-0:101;1:0-0:101;1:0-0:101;1:0-0:101;1:0-0:101;1:0-0:101;1:0-0:101;1:0-0:101;1:0-0:101;1:0-0:101
1:0-0:101;1:0-0:101;1:0-0:101;1:0-0:101;1:0-0:101;1:0-0:101;1:0-0:101;1:0-0:101;1:0-0:101;1:0-0:101;1:0-0:101;1:0-0:101;1:0-0:101;1:0-0:101;1:0-0:101;1:0-0:101;1:0-0:101;1:0-0:101
1:0-0:101;1:0-0:101;1:0-0:101;1:0-0:101;1:0-0:101;1:0-0:101;1:0-0:101;1:0-0:101;1:0-0:101;1:0-0:101;1:0-0:101;1:0-0:101;1:0-0:101;1:0-0:101;1:0-0:101;1:0-0:101;1:0-0:101;1:0-0:101
